R 800 600

EA ./textures/texture-3c.xpm
NO ./textures/texture-claire.xpm
WE ./textures/texture-alban-W.xpm
SO ./textures/texture-4f.xpm
S ./textures/sky.xpm

F 200,200,200
C 0, 0, 50

11111111111111111111111111111
10000000001100000000000000001
10110000011100020000000010001
10120000000000000000000010001
10110000011100000000000010001
10000000001100000111011110001
11110111111111011100000010001
11110111111111011101010000001
11000000110101011000000000001
10002000000000000000000000001
10000000000000001101010010001
11000000110101011111011110001
111101111111010111110111100N1
11111111111111111111111111111