R 1 1
NO ./textures/cobble.xpm
SO ./textures/grass.xpm
WE ./textures/snow.xpm
EA ./textures/oak.xpm

S ./textures/sapling.xpm
C 30,100,130
F 116,180,74

111111111111111
100000000000101
11000100020010111
 1111100000000001
11000000001010111
1000000N1111101
100200000000001
100000000000001
11111110011110111
  100000000000001
11111111111111111
