R 1000 800
NO ./textures/cobble.xpm
SO ./textures/grass.xpm
WE ./textures/snow.xpm
EA ./textures/oak.xpm

R 400 800
S ./textures/sapling.xpm
C 30,100,130
F 116,180,74

111111111111111    111
100000000000101    101
11000100020010111  101
 1111100000000001  101
11000000001010111  101
1000000N1111101    101
100200000000001    101
100000000000001    101
11111110011110111  101
  100000000000001  101
11111111111111111  111
