R 1000 800
NO ./textures/cobble.xpm
SO ./textures/grass.xpm
WE ./textures/snow.xpm
EA ./textures/oak.xpm

S ./textures/sapling.xpm
C 30,100,130
F 116,180,74

111111111111111
102222220000121
100000000000001
100000000000001
100000000000001
100000000000001
100000000000001
100000000000001
100000000000001
100000000000001
100000000000001
100000000N00001
100000000000001
111111111111111
