R 1600 800
NO ./textures/mossy.xpm
SO ./textures/redbrick.xpm
WE ./textures/stone.xpm
EA ./textures/wood.xpm

S ./textures/pillar.xpm
F 35,130,30
C 30,100,130

111111111111111
100000000000101
100001000000101
111100000010101
100000000010101
1000000N1111101
100200000000001
100000000000001
111111100111101
100000000000001
111111111111111
