R 1920 1080
NO ./textures/mossy.xpm 
SO ./textures/redbrick.xpm
WE ./textures/stone.xpm  
EA ./textures/wood.xpm  

S ./textures/wood.xpm
F 200,200,200
C 0,0,50

111111111111111
100000000000101
100001000000101
111100000010101
100000000010101
100000001111101
100000000000001
100000000000001
111111100111101
100000000000001
111111111111111
