R 800 800
NO ./textures/cobble.xpm
SO ./textures/grass.xpm
WE ./textures/snow.xpm
EA ./textures/oak.xpm

S ./textures/sapling.xpm
F 116,180,74
C 30,  120,130

1111
1001
1001
1001
1001
10S1
1001
1001
1001
1001
1001
1001
1001
1001
1221
1111
