R 1000 800
NO ./textures/cobble.xpm
SO ./textures/grass.xpm
WE ./textures/snow.xpm
EA ./textures/oak.xpm

S ./textures/sapling.xpm
C 30,100,130
F 116,180,74

1111111
1220121
1000001
1000001
1000001
1000001
1000001
1000001
100N001
1000001
1111111
