R 1000 1000
NO ./textures/musee_1.xpm
SO ./textures/musee_2.xpm
WE ./textures/musee_3.xpm
EA ./textures/musee_4.xpm

S ./textures/Sprite.xpm
C 64,64,64
F 70,0,10

1111111111111111
1000000000000101
11000100020010111
 1111100000000001
11000001101010111
100000001111101
1002000S0000001
100000000000001
11111110011110111
  100000000000001
11111111111111111
